00 00 00 00 00 00 00 00 
bf b0 dc 61 55 c3 00 00 
00 00 00 00 00 00 00 00
00 00 00 00 00 00 00 00
00 00 00 00 00 00 00 00

80 dc 61 55 00 00 00 00
fa 18 40 00 00 00 00 00
35 39 62 39 39 37 66 61 
